W J 0 B W
J 0 W W 0
0 0 J 0 0
W 0 W 0 J
B W 0 J W