W B 0 B J
J 0 B J 0
0 0 J 0 0
B 0 B 0 B
B J 0 B W